0 **x* -> W 3
0 **W* -> X 1
1 ***x -> S 0
1 ***S -> X 2
2 *x** -> E 1
2 *E** -> X 3
3 x*** -> N 2
3 N*** -> X 0
